###############
#S#           #
# ##### # #####
# #   # #     #
# # # ##### # #
#   #     # # #
######### # # #
#       # # # #
# # ##### # # #
# # #   # # # #
# ### # # ### #
#   # #   #   #
# # # ##### # #
# #         #E#
###############
