#################################
#S#       #         #       #   #
# ##### ### ##### # ### ### ### #
# #   #     #     #     #   #   #
# # # ##### # ########### ### ###
#   #     # # # #   #   #   #   #
######### # # # # # # # ### ### #
#       # # # #   # # #     #   #
# # ##### # # ### # # ####### # #
# # #   # # #   # # #     #   # #
### # # # # ### # # ##### ### ###
#   # #   # #   # #   # #   #   #
# ### ####### ### # # # ### ### #
#   #         # # # #     #     #
# # ########### # # ##### ##### #
# #       #       #   # #     # #
######### # ######### # ### ### #
#       #           # # #   #   #
# ##### ########### # # # ### ###
# #           #   # # #     #   #
# ########### # # ### ######### #
#           #   #   #   #   #   #
# ######### ####### ### # # # ###
# #       #   #         # #   # #
# # ### ##### ########### ##### #
# # #   #   # #           #   # #
# # # ### # # # ########### # # #
# # #   # #   # #   #   #   #   #
# ##### # ##### # # ### # # #####
# #     #       # #   #   #     #
# # ### ######### ### ######### #
#   #             #            E#
#################################
