#################################
#S#     #     #             #   #
# ### # ### # # # ######### # # #
# #   #     # # #   #       # # #
# # ######### ##### # ####### # #
# # #   #   #   #   #       # # #
# # # ### # ### # ######### # ###
#   #   # #     #     #   # #   #
##### # # ########### # ### ### #
#     #               #        E#
#################################
