#############
#S#         #
# ##### #####
# #   #     #
# # # ##### #
#   #     # #
######### # #
#       # # #
# # ##### # #
# #     # # #
# ##### # # #
#     #    E#
#############
