#####
#S  #
### #
# # #
# # #
#  E#
#####
