###############################################
#S#     #       #               #             #
# ##### # ### # # ####### ##### ############# #
# #   #     # # #   #   #     #   #           #
# # # ##### # # ##### # ##### ### # ######### #
#   #     # # #   #   #       # #   #       # #
######### ### ### # ########### ##### # ##### #
# #     # #   # # # #           #     #       #
# # # ### # ### # # # ######### # #############
#   #       #       #         #              E#
###############################################
